S.##.....T
#.##..#S#.
#.###E###E
#TE...###.
###T#####G